.................................******.............................
...................................****.............................
...................**.............***...............................
.................******..........****...................***.........
..**.........************.......*****....................**.........
...**.............******..........**................*******.........
...**...............****..........................**********........
...***.........*******.....................**........*****..........
....****........................****......****......................
....*******................********.......*.*.......................
..***....********..............******.......*.......**********......
*****...********..............*******.................************..
**********........................****..............****************
.****.............******................................****..******
.................************........................*******.....***
...........************..***********................................
.......***************.......*************..........**..*...........
...........**************************..............*******..........
.....**********************..........................***............
..........************.............................********.........
